,Akten,Beschuldigte,Betroffene,Forschungsliteratur,Kirchenverantwortliche,Kirchliche MA,Sonstige Quellen,Umfeld,Sum
Berührungen,3,1,7,1,0,1,0,9,22
Entblößen des eigenen Körpers,0,0,0,0,0,0,0,0,0
Penetration,1,0,0,0,0,0,0,0,1
Sprache/Gesten/Aufforderungen,1,1,1,0,1,0,0,2,6
Verhältnis,0,0,0,0,2,0,0,1,3
nicht spezifizierte Taten,0,0,2,1,0,3,0,5,11
reproduktiv,0,0,1,0,0,0,0,2,3
spirituell,0,0,1,0,0,0,0,1,2
weitere Vorwürfe,0,0,2,0,2,2,0,6,12
Sum,5,2,14,2,5,6,0,26,60
