,Meldung,Reaktion,Tat,weitere Zeitangaben,Sum
Dummheit,3,2,2,0,7
Gefahr für priesterliches Ansehen,1,1,1,0,3
Kirchenrechtlich,1,1,1,0,3
Missbrauch,8,2,6,0,16
Schutz- und Hilfsbedürftigkeit,1,1,1,0,3
Strafrechtlich,4,2,2,0,8
Verführung,3,2,2,0,7
Verhältnis,9,3,7,1,20
Verstoß gegen 6. Gebot,1,1,1,0,3
Weitere Framings,2,2,2,0,6
Zölibatsverstoß,0,0,1,0,1
moralische Verurteilung,3,2,3,0,8
unerheblich,3,2,1,0,6
verklausuliert,3,2,3,0,8
"Übergriff, Gewalt etc.",1,1,1,0,3
Sum,43,24,34,1,102
