,Akten,Beschuldigte,Betroffene,Forschungsliteratur,Kirchenverantwortliche,Kirchliche MA,Sonstige Quellen,Umfeld,Sum
Berührungen,4,3,4,1,3,2,0,5,22
Entblößen des eigenen Körpers,0,0,0,0,0,0,0,0,0
Penetration,2,2,4,1,1,1,0,2,13
Sprache/Gesten/Aufforderungen,3,3,2,1,3,2,0,3,17
Verhältnis,0,3,0,0,2,0,0,2,7
nicht spezifizierte Taten,3,2,5,1,3,2,0,8,24
reproduktiv,0,1,2,0,1,0,0,2,6
spirituell,2,1,2,1,1,1,0,2,10
weitere Vorwürfe,3,5,2,1,4,4,0,6,25
Sum,17,20,21,6,18,12,0,30,124
