,Meldung,Reaktion,Tat,weitere Zeitangaben,Sum
Beichte,1,1,1,0,3
Bildung,4,2,2,0,8
DienstverhÃ¤ltnis,3,2,3,0,8
Geistliche Begleitung,0,0,0,0,0
Geistliche Gemeinschaften,0,0,0,0,0
Jugendarbeit,2,2,1,0,5
Kategoriale Seelsorge,0,0,0,0,0
Orden,0,0,0,0,0
Pfarrei,5,2,4,0,11
Seelsorge,0,0,0,0,0
weitere Tatkonstellationen,4,2,4,1,11
Sum,19,11,15,1,46
