,Meldung,Reaktion,Tat,weitere Zeitangaben,Sum
Berührungen,7,4,6,0,17
Entblößen des eigenen Körpers,0,0,0,0,0
Penetration,2,2,2,0,6
Sprache/Gesten/Aufforderungen,4,3,2,0,9
Verhältnis,3,1,3,1,8
nicht spezifizierte Taten,10,4,8,0,22
reproduktiv,1,1,2,1,5
spirituell,1,1,1,0,3
weitere Vorwürfe,7,3,7,1,18
Sum,35,19,31,3,88
